Motherboard = Μητρική κάρτα
RAM(random access memory) = Μνήμη τυχαίας προσπέλασης
Card = Κάρτα
HDD(hard disk drive) = Μαγνητικός σκλήρος δίσκος
Browser = Φυλλομετρητής
SSD(solid state drive) = Σκληρός δίσκος στερεάς μορφης
PSU(power supply unit) = Μονάδα τροφοδοσίας
Keyboard = Πληκτρολόγιο
Mouse = Ποντίκι
Mousepad = Μαξιλαράκι ποντικιού
Hardware = Υλικό
Speakers = Ηχεία
Headphones = Ακουστικά
Fans = Ανεμιστήρες
Cooler = Ψύκτρα
Desktop = Σταθερός υπολογιστής
AIO(All-in-one) cooler = Ψήκτρα (Όλα σε ένα)*
Heat-sink = παθητικός εναλλακτής θερμότητας*
Case = Κουτί
PC(personal computer) = Προσωπικός υπολογιστής
PCI(peripheral component interconnect) = Περιφερείακη διασύνδεση εξαρτημάτων
ROM(read-only memory) = Μνήμη μόνο ανάγνωσης
Socket = Θύρα επεξεργαστή*
Plug = Βίσμα
Button = Κουμπί
USB(universal serial bus) = Γενικός σειριακός δίαυλος
VRM(voltage regulator module) = Συσκευή διαμόρφωσης VOLT
CMOS(complementary metal oxyde semiconductor) = Συμπληρωματικός ημιαγωγός μεταλικού οξιδίου
Cache = Ενσωματωμένη μνήμη επεξεργαστή
CD-R(compact disc read only) = Συσκευή Ανάγνωσης CD
CD-RW(compact disc read/write) = Συσκευή ανάγνωσης/εγγραφής CD
TDP(thermal design power = Σημείο Θερμικής σχεδίασης*
DVD-R(digital versatile disc read only = Συσκευή ανάγνωσης DVD
DVD-RW(digital versatile disc read/write) = Συσκευή ανάγνωσης/εγγραφής DVD
Chipset = Ομάδα ολοκληρωμένων κυκλωμάτων
PWM(pulse width modulation) = Σύνδεση διαχείρισης παλμού*
Serial = Σειριακό,
CAS(column address strobe/signal) = Σήμα διεύθυνσης στήλης*
Latency = Καθυστέρηση μεταφοράς
Router = Δρομολογητής
Ports = Θύρες
Radiator = Ψυγείο
UI(user interface) = Διεπαφή χρήστη
GUI(graphics user interface) = Διεπαφή χρήστη με γραφικά
Software = Λογισμικό
Authentication = Αυθεντικοποίηση
VGA(Video graphics Array) = Δίαυλος γραφικών
DVI(Digital Video Interface) = Ψηφιακός δίαυλος γραφικών
Login = Είσοδος
OS(operating system) = Λειτουργικό Σύστημα
HDMI(High Definition Multimedia Interface) = Δίαυλος υψηλής ευκρίνειας
Patch = Λογισμικό αναβάθμισης
CLI(command line interface) = Διεπαφή γραμμής εντολών
BIOS(basic input/output system = Βασικό σύστημα εισαγωγής/εξαγώγης
Virus = Ιός
Antivirus = Αντιιικό
Overclock = Υπερχρονισμός
Console = Κονσόλα
Image = Φωτογραφία
Command = Εντολή
Format = Μορφοποίηση
Update = Αναβάθμιση
Database = Βάση δεδομένων
Server = Διακομιστής
Backup = Αντίγραφο
Wallpaper = Φόντο
Font = Γραμματοσειρά
Download = Λήψη
Upload = Φόρτωση
Code = Κώδικας
Configuration = Διαμόρφωση
Settings = Ρυθμίσεις
Shortcut = Συντόμευση
Shell = Κέλυφος
Transfer rate = Ρυθμός μετάδοσης
Algorithm = Αλγόριθμος
Bandwidth = Έυρος ζώνης
TCP/IP(transfer control protocol over internet protocol) = Πρωτόκολο μεταφοράς δεδομένων internet
Network = Δίκτυο
LAN(local area network) = Τοπικό δίκτυο
Host = Οικοδεσπότης
Service = Υπηρεσία
Administrator = Διαχειριστής
Provider = Πάροχος(Διαδικτύου)
ipv4(internet protocol version 4) = Πρωτόκολλο internet έκδοση 4
ipv6 = Πρωτόκολλο internet έκδοση 6
Switch = Διακόπτης
Hub = Κεντρικό σημείο
Cable/wire = Καλώδιο
Wireless = Ασύρματο
Reset = Επαναφορά
DNS(domain name server) = Διακομιστής ονομασίας τομέα
Address = Διεύθυνση
BPS(bits per second) = Bits ανά λεπτό
Package = Πακέτο
Timeout = Διακοπή χρόνου
Transmitter = Μεταδότης
Receiver = Δέκτης
Bearing = Ρουλεμάν
NVME(Non-volatile memory express) = μη-πτητική ταχεία μνήμη
SATA(Serial Advanced Technology Attachment) = Σειριακή σύνδεση προηγμένης τεχνολογίας
Save = Αποθήκευση
Distribute = Διανέμω
Connection = Σύνδεση
Button = Κουμπί
Collision = Πρόσκρουση
Segment = Τμήμα
Traffic = Κίνηση
Parallel = Παράλληλο
Peer = Ομότιμος
Token = Κουπόνι
Model = Μοντέλο
Mesh = Πλέγμα
Broadband = Ευρυζωνικό
Optic = Οπτικό
Fiber = Ίνα
Text = Κείμενο
Twisted = Στριμμένο
Pair = Ζευγάρι
Enhanced = Ενισχυμένο
Copy = Αντιγραφή
Paste = Επικόλληση
Default = Προκαθορισμένο
Analog = Αναλογικό
Digital = Ψηφιακό
Binary =  Δυαδικό
Layer = Στρώσεις/Επίπεδα
Signal = Σήμα
Programming language = Γλώσσα προγραμματισμού
Artificial = Τεχνητό
Intelligence = Νοημοσύνη
Access point = Σημείο πρόσβασης
Application = Εφαρμογή
Attachment = Συνημμένο
File = Αρχείο
Chat = Συνομιλία
Compress/Zip = Συμπίεση αρχειου
Cyberspace = Κυβερνοχώρος
DIMM = Κύκλωμα υποδοχής γκρούπ μνήμης
Simulation = Προσομοίωση
Expansion Card = Κάρτα Επέκτασης
Firewall = Τείχος προστασίας
Folder = Φάκελος
Freeware = Λογισμικό χωρίς χρέωση
FTP(File Transfer Protocol) = Πρωτόκολλο μεταφοράς δεδομένων
Link = Σύνδεσμος
Pixel = Εικονοστοιχείο
Username = Όνομα χρήστη
Password = Κωδικός πρόσβασης
Virtual = Εικονικό
Reality = Πραγματικότητα
VPN(Virtual Private Network) = Εικονικό προσωπικό δίκτυο
